Nirvana = Målet för alla buddhister.
En himmel eller ett sätt att känna och uppleva, ett tillstånd.
Offra = Att ge något till Gud.
Predika = När prästen talar om Gud i kyrkan.
Profet = En person som har fått i uppdrag av en gud att framföra den gudens budskap.
Präst = Den som leder en kristen gudstjänst.
Den som leder hinduiska ceremonier kallas också för präst.
Psalm = En religiös kristen sång.
Rabbin = Den som talar i synagogan och förklarar den judiska tron.
Rabbinen är ledaren i synagogan.
Religiös = Att tillhöra en religion.
Rökelse = Trästickor doppade i en växtblandning som brinner långsamt.
Många tycker att röken som bildas luktar gott.
Sabbat = Den judiska vilodagen.
Sakrament = En helig handling och en ceremoni som präster utför.
Samsara = Evigt kretslopp, det vill säga att allt går i cirklar utan slut.
Sed = En sed är en tradition, något man gör på samma sätt varje gång.
Själ = En människas personlighet.
Vissa tror att när kroppen dör så lever själen vidare.
Sunna = De vanor och traditioner som Muhammed hade.
Symbol = Något som används som ett tecken för något.
Ett hjärta är till exempel en symbol för kärlek.
Synagoga = Den plats där judar samlas för att hålla gudstjänst.
Synda = Att göra något som inte är tillåtet.
Tempel = En religiös byggnad där man kan be.
Testamente = Något man skriver innan man dör.
Där bestäms bland annat vem som får ärva pengar och annat.
Tora = Judarnas heliga bok.
Tradition = Gemensamma vanor, något man gör på samma sätt varje gång.
Uppstå = Att vakna upp från döden.
Vallfärda = Att resa till en viktig plats.
Vedaböckerna = Heliga böcker för hinduer.
Vigsel = Ceremonin då man gifter sig.
Välsignelse = Att får beskydd och hjälp av Gud.
Religiös = Att tillhöra en religion och följa de traditioner och högtider som hör till den religionen.
Troende = En person som tror på Gud.
Högtid = När människor samlas för att fira något speciellt.
Tripitaka = Heliga böcker för buddhister.