Ordlista  
Glossary  
词汇表  
  
Allah = Islams namn på Gud.  
Allah = Islam's name for God.  
安拉=伊斯兰教对上帝的称呼。  
  
Asket = En person som lever enkelt och fattigt.  
Ascetic = A person who lives simply and poorly.  
苦行僧=生活简单和贫穷的人。  
  
Bibeln = Kristnas heliga bok.  
Bible = The holy book of Christians.  
圣经=基督徒的圣书。  
  
Buddha = Att bli upplyst, att se sanningen.  
Buddha = To become enlightened, to see the truth.  
佛陀=觉悟，看见真理。  
  
Budorden = Tio budord, regler, som Mose fick av gud. Där berättar Gud hur han vill att människorna ska leva.  
The commandments = Ten commandments, rules, that Moses received from God. There God explains how he wants people to live.  
诫命=摩西从上帝那里得到的十条诫命，规则。上帝在其中讲述了他希望人们如何生活。  
  
Bön = Ett sätt att prata med Gud.  
Prayer = A way to talk to God.  
祷告=与上帝交流的一种方式。  
  
Ceremoni = En högtidlig stund där man läser texter och kanske sjunger sånger. Till exempel bröllop och dop.  
Ceremony = A solemn occasion where texts are read and perhaps songs are sung. For example, weddings and baptisms.  
仪式=一种庄重的场合，在那里阅读文本，也许还唱歌。例如，婚礼和洗礼。  
  
Fasta = Att inte äta eller dricka.  
Fasting = Not eating or drinking.  
斋戒=不吃或者喝。  
  
Förbund = Överenskommelse.  
Covenant = Agreement.  
盟约=协议。  
  
Förfäder = En persons släktingar från förr.  
Ancestors = A person's relatives from the past.  
祖先=一个人过去的亲属。  
  
Guds son = Jesus.  
Son of God = Jesus.  
上帝之子=耶稣。  
  
Halal = Mat som är tillåten att äta för muslimer.  
Halal = Food that is permitted for Muslims to eat.  
清真=穆斯林被允许吃的食物。  
  
Hebreiska = Judarnas religiösa språk.  
Hebrew = The religious language of the Jews.  
希伯来语=犹太人的宗教语言。  
  
Helig = Något som är gudomligt och speciellt. Det är också något som är mycket viktigt.  
Holy = Something that is divine and special. It is also something that is very important.  
圣=神圣且特别的东西。也是非常重要的东西。  
  
Imam = Den som leder bönen och ceremonier i moskén.  
Imam = The one who leads the prayer and ceremonies in the mosque.  
伊玛目=在清真寺领导祈祷和仪式的人。  
  
Kanaan = Det land som Abraham fick av Gud.  
Canaan = The land that Abraham received from God.  
迦南=亚伯拉罕从上帝那里得到的土地。  
  
Kantor = Den som leder den judiska gudstjänsten med sång och läsning ur den judiska Bibeln.  
Cantor = The one who leads the Jewish service with song and reading from the Jewish Bible.  
圣咏团员=通过歌唱和阅读犹太圣经领导犹太教礼拜的人。  
  
Karma = Summan av alla goda och dåliga handlingar som en människa har gjort i sitt liv.  
Karma = The total of all good and bad actions a person has done in their life.  
业=一个人在其一生中所做的所有善恶行为的总和。  
  
Kaster = De grupper som människor i Indien föds i och tillhör hela livet.  
Castes = The groups that people in India are born into and belong to for their entire lives.  
种姓=人们在印度所出生并终生隶属的群体。  
  
Koranen = Muslimernas heliga bok.  
Quran = The holy book of Muslims.  
古兰经=穆斯林的圣书。  
  
Kosher = Mat som följer de judiska reglerna för vilken mat man får äta.  
Kosher = Food that follows the Jewish rules for what food can be eaten.  
洁食=符合犹太教规可以吃的食物。  
  
Kremera = Att elda upp en kropp så att den bara blir aska.  
Cremate = To burn a body so that it becomes only ashes.  
火化=烧毁一具身体，使其只剩灰烬。  
  
Kyrka = Den plats där kristna samlas för att hålla gudstjänst.  
Church = The place where Christians gather to hold worship.  
教堂=基督徒聚集举行礼拜的地方。  
  
Lärjunge = En person som följer en lärare. Jesus hade tolv lärjungar som följde honom och lyssnade till det som han berättade.  
Disciple = A person who follows a teacher. Jesus had twelve disciples who followed him and listened to what he told them.  
门徒=跟随老师的人。耶稣有十二名门徒跟随他并听他所讲述的内容。  
  
Meditation = Att sitta i en särskild ställning och tänka koncentrerat på en tanke eller ett ord. Målet är att skapa lugn i sinnet.  
Meditation = To sit in a specific position and focus on a thought or a word. The goal is to create calm in the mind.  
冥想=坐在特定的位置，专注于某个思想或单词。目标是让心灵平静。  
  
Minaret = Ett högt torn där man ropar ut när det är tid för bön.  
Minaret = A tall tower from which the call to prayer is announced.  
宣礼塔=在祷告时间进行宣告的高塔。  
  
Moské = Den plats där muslimer samlas för att be till Gud.  
Mosque = The place where Muslims gather to pray to God.  
清真寺=穆斯林聚集祈祷的地方。  