涅槃 = 所有佛教徒的目标。
一种天堂或感受和体验的一种状态。
牺牲 = 把某物献给上帝。
讲道 = 当牧师在教堂里谈论上帝时。
先知 = 受神委托传达神的讯息的人。
牧师 = 领导基督教礼拜的人。
领导印度教仪式的人也被称为牧师。
赞美诗 = 一首宗教基督教歌曲。
拉比 = 在犹太教堂讲话并解释犹太信仰的人。
拉比是犹太教堂的领袖。
宗教的 = 属于宗教。
香 = 浸入植物混合物中缓慢燃烧的木棒。
许多人认为产生的烟闻起来很好。
安息日 = 犹太人的休息日。
圣事 = 牧师执行的神圣行为和仪式。
轮回 = 永恒的循环，即一切都在无尽的圆圈中运行。
习俗 = 一种传统，每次都以相同方式进行的事情。
灵魂 = 一个人的个性。
有些人认为当身体死去时，灵魂继续存在。
逊奈 = 穆罕默德的习惯和传统。
符号 = 用作某种征兆的事物。
例如，心形是爱情的象征。
犹太教堂 = 犹太人聚集进行礼拜的地方。
罪 = 做不允许的事情。
寺庙 = 可以祈祷的宗教建筑。
遗嘱 = 在死亡前撰写的东西。
其中规定谁将继承金钱和其他物品。
托拉 = 犹太人的圣书。
传统 = 共同习惯，每次都以相同方式进行的事情。
复活 = 从死亡中醒来。
朝圣 = 去重要地方旅行。
吠陀经 = 印度教的圣书。
婚礼 = 一个人结婚时的仪式。
祝福 = 得到上帝的保护和帮助。
宗教 = 属于一个宗教并遵循与之相关的传统和节日。
信徒 = 相信上帝的人。
节日 = 人们聚集庆祝某件特别的事情。
三藏 = 佛教徒的圣书。